7
.....o....o...
.o...o........
..o..o.o.o.o..
....o.o.......
..............
....o.........
.....o........
..............
